---------------------------------------------------------------------------------------------------------------------------------------------------------------------------------------------------------------------
---------------------------------------------------------------------------------------------------------------------------------------------------------------------------------------------------------------------
---------------------------------------------------------------------------------------------------------------------------------------------------------------------------------------------------------------------
---------------------------------------------------------------------------------------------------------------------------------------------------------------------------------------------------------------------
?------?#-#--------#-----#-?-?-----#-#-?-------#?---------------?-------?#--?-#----#----?-----------------?---#---#-#?-#--#-##--?-?????-?----?-#------------------#?--#---------#-----------------?----#-----?-#--#--
-----------------------=----=-------------------------------------------------------------------------------------------------=--------------------------------------=-----------------------------------------------
-----------------------=----=-------------------------------------------------------------------------------------------------=--------------------------------------=-----------------------------------------------
------c----------------=----=-e---------------------c-------------e-----------------------------------------------------------=--e---------------------------c-------=-----------------------------------------------
#p----##----------#----=--##=#-#e-?-#--##-------#---#---------###-------#---#-------p-=-#------------#----#----------##----#--=-#-#####-#----#-----------=---#---p-##=-------------p----------p---?-------#--#-------
-p----c----------------=----=--------------=--------c-------------------------------p-=----------------------------=----------=-------------------------c=---c---p---=-------------p----------p----=-----------------
-p----#----------------=----=--------------=--------#---------------------------p---p-=----------------------------=----------=---------------=---------#=---#---p---=----=--------p----------p----=-----------------
-p----#--------------=-=----=--------------=--------#--=------------------------p---p-=----------------------------=----------=---------------=---------#=---#---p---=----==-------p----------p=---=-------------=--=
===-=====-=--====================-================-======--================-=-===========--===--==--==----=====---======--=====-=====================================================-==--==-====-====-==-====-======
