---------------------------------------------------------------------------------------------------------------------------------------------------------------------------------------------------------------------
---------------------------------------------------------------------------------------------------------------------------------------------------------------------------------------------------------------------
---------------------------------------------------------------------------------------------------------------------------------------------------------------------------------------------------------------------
---------------------------------------------------------------------------------------------------------------------------------------------------------------------------------------------------------------------
#-##--?-----?---------#----#-------??------------?-------------??-?---=--------------------------#-----------#-------------------#---#-?---------------------------#---?----?----------?-#-----?---------?--------#--
--------------=-------------------------------------------------------=------------------------=------------=------------------------------------------------=-----------------------------=-------=-----------------
--------------=-------------------------------------------------------=------------------------=------------=------------------------------------------------=-----------------------------=-------=-----------------
--------------=---------e---------e------------------e----------------=---c----------e---------=-------e----=---------------------------e------------e-------=--e---e------e---------------=-------=------c------c---
----###-#--##-=------p-#-----#---#-##-----p------?-----p--#----??-#---=---#----p---pp--p-------=------=-=p--=-#--?p----p?----?=--------#----------#------#---=---------?----?pp--p-----#---=#-=#---=-----##-p---##---
-------------c=------p---------------=----p------------pc------------==---c----p---pp--p-=-----=------=-=pc-=-----p----p------=------------------------------=------------c--pp--p---------=--=----=------c-p-c--c---
-------------#=----=-p---------=-----=----p------------p#------------==---#---=p---pp--p-=-----=------=-=p#-=-----p----p------=------------------------------=-----------=#--pp--p---------=--=----=------#-p-#--#---
-------------#=----=-p---------=-----=----p------------p#------------==---#---=p---pp--p-=-----=-----==-=p#-=-----p----p------=------------=----------=------=-----------=#--pp--p---------=--=----=------#-p-#=-#---
=================-==========-=======================-============-=-========================================================-=============================-=========================================================-
