---------------------------------------------------------------------------------------------------------------------------------------------------------------------------------------------------------------------
---------------------------------------------------------------------------------------------------------------------------------------------------------------------------------------------------------------------
---------------------------------------------------------------------------------------------------------------------------------------------------------------------------------------------------------------------
---------------------------------------------------------------------------------------------------------------------------------------------------------------------------------------------------------------------
------------#-----------------#------------------------------------------#---#----------------------------#-------------------#-#-----#--?-----#--#---------------#--------------------------------------------------
----------------------------------------------------------------------------=---------------------------------=-------------------------------------------------------=----------------------------------------------
----------------------------------------------------------------------------=---------------------------------=-------------------------------------------------------=----------------------------------------------
---------------------------------------------c------------------------------=---------------------------------=---------------------------c--------------c------------=----------------------------------------------
-#---------------------p----=--?-------------#------?-------------pp----?---=-=----------#------------p------?=---pp--------------p------##p-------------#-----p-----p=----?---------------p----------?-----?--------
-----------------------p----=---------------=c--------------------pp--------=-=-----------------------p-------=---pp--------------p-------cp-------------c-----p-----p=--------------------p--------------------c----
-----------------------p----=---------------=#-=-------------p----pp--------=-=-----------------------p-------=---pp--------------p-------#p-------------#-----p-----p=----------------=---p--------------------#----
-----------------------p----=---------------=#-=-------=-----p----pp--------=-=-----------------------p-------=---pp--------------p-------#p-------------#-----p-----p=--------=-------=---p--------------------#----
===========-====-===--===========-===-====-===============-========================-====-==========--=======-=============-==================-================-==========================-======-====================
