---------------------------------------------------------------------------------------------------------------------------------------------------------------------------------------------------------------------
---------------------------------------------------------------------------------------------------------------------------------------------------------------------------------------------------------------------
---------------------------------------------------------------------------------------------------------------------------------------------------------------------------------------------------------------------
---------------------------------------------------------------------------------------------------------------------------------------------------------------------------------------------------------------------
--------------------------------------------------------#---?-----?---------------------------------------=--------------------------------------#-------------------------------------------------------------------
----------------------------------------------------------------------------------------------------------=----------------------------------------------------------------------------------------------------------
----------------------------------------------------------------------------------------------------------=----------------------------------------------------------------------------------------------------------
---------c--------------------c-----------------------------------------------------------e-c----c--------=-------------------------------e-------------------------------------------------c------------------------
---------#--------------------#-----------#-----------------?#----?-------------------------#----#--------=----------------------------------------------------#-------------------#-p------#------=-=---------------
---------c--------------c-=---c-------------------------------------------cc-----------cc---c----c--------=------c----------c----------------c-------------------c------------c------p------c------=-=-------c------c
---------#--------------#-=---#-------------------------------------------##-----------##---#----#--------=------#----------#----------------#-------------------#------------#------p------#------=-=-------#------#
---------#--------------#-=---#-------------------------------------------##-----------##---#----#--------=------#----------#----------------#-------------------#------------#------p------#------=-=-------#------#
=======-=========-=-=============-=====-===========-==========-==========================================-======================================-========-============================================-==============
