---------------------------------------------------------------------------------------------------------------------------------------------------------------------------------------------------------------------
---------------------------------------------------------------------------------------------------------------------------------------------------------------------------------------------------------------------
---------------------------------------------------------------------------------------------------------------------------------------------------------------------------------------------------------------------
---------------------------------------------------------------------------------------------------------------------------------------------------------------------------------------------------------------------
------##-#-#--#-------------?-------#--------------------#--#------------?---?-----------#-----##---?------------------------#-#-----#--#--#------##--------------?----?----#-#-----?-----?--#-#?---#-----###?##-----
--------------------------------------------------------------------------------------=------=-----------------------------------------------------------------=---------------------=-------------------------------
--------------------------------------------------------------------------------------=------=-----------------------------------------------------------------=---------------------=-------------------------------
-------------------------c-----------------c------------------e-----------------------=------=----c-----------------------------c-c--------------------c-------=---------c-c---------=-------------------------------
----------?-p#-#-?-------#???=#?-----------#--#-----=-----p-------#-----=#---?-----#--=---=--=#---#-?----=-----=------=-------p-#-#-=---------p-------##-----=-=--##---?-#-#------=-#=#---#-----#=---#?------#---p=--
------------p------------c---=-------------c--------=-----p-------------=-----------p-=---=--=----c------=--c--=----c-=-------p-c-c-=-----c---pc-------c-----=-=----c----c-c------=--=-----------=------c--------p=--
-----p------p------------#---=-------------#-----=--=---=-p-------------=-----------p-=---=--=---p#------=-=#--=--=-#-=-------p-#-#-=-----#---p#-------#-----=-=----#=---#-#------=--=---p-------=------#--------p=--
-----p------p-------=----#---=-------------#-----=--=---=-p-------------=-----------p-=---=--=---p#------=-=#--=--=-#-=-------p-#-#-=-----#---p#-------#-----=-=----#=---#-#------=--=---p-------=-=----#--------p=--
=--=====-=============-========================-===============--=====-=========-=-==============================-=-====-===-======-=================-====---===================-==-====-===-==========-========-====
