---------------------------------------------------------------------------------------------------------------------------------------------------------------------------------------------------------------------
---------------------------------------------------------------------------------------------------------------------------------------------------------------------------------------------------------------------
---------------------------------------------------------------------------------------------------------------------------------------------------------------------------------------------------------------------
---------------------------------------------------------------------------------------------------------------------------------------------------------------------------------------------------------------------
----#-----#--#--#----------------------------------------------------------------------------------------------------------------------------------------------------------------------------------------------------
------------------=--=---=--=--=--=---------------------------==--=------=------=-------==--------------=---=--=--=--=--------=-----------=----=--------==---------=--------------=----=-------=---------------------
------------------=--=---=--=--=--=---------------------------==--=------=------=-------==--------------=---=--=--=--=--------=-----------=----=--------==---------=--------------=----=-------=---------------------
--c---------------=--=---=--=--=--=---------------------------==--=------=------=-------==--------------=---=--=c-=--=--------=-----------=----=--------==---------=--------------=----=-------=---------------------
--#--------=---=--=-==p--=-==-=====-==-#-=======--==#-===--======-=-=-====--======-=#p=-==-========p==-===-=====#================-==-====-==-=-==-=-========---======-=p-=-=-===-=====-=======================-==-=--
--c=-------=---=--=-==p--=-==-=====-==---=======--==--===--======-=-=-====--======-=-p=-==-========p==-===-=====c================-==-====-==-=-==-=-========---======-=p-=-=-===-=====-=======================-==-=--
p-#=-------=---=--====p=-====-=====-===--=======-===--===-=======-=-=-====-=========-p====-========p==-===-=====#===================-====-==-=-====-========-=-========p====-===-=============================-====--
p-#=-----=-=---=--====p=-==========-===-========-===--===-=======-=-=-====-=========-p====-========p==-===-=====#========================-==-=-====-========-==========p====-===-===================================-
=-===================================================================================================================================================================================================================
