---------------------------------------------------------------------------------------------------------------------------------------------------------------------------------------------------------------------
---------------------------------------------------------------------------------------------------------------------------------------------------------------------------------------------------------------------
---------------------------------------------------------------------------------------------------------------------------------------------------------------------------------------------------------------------
---------------------------------------------------------------------------------------------------------------------------------------------------------------------------------------------------------------------
---------------------------------------------------------------------------------------------------------------------------------------------------------------------------------------------------------------------
---------------------------------------------------------------------------------------------------------------------------------------------------------------------------------------------------------------------
---------------------------------------------------------------------------------------------------------------------------------------------------------------------------------------------------------------------
--------------------------------------------------------------------------------------------------------------------------------------------------------------------------------------------------------------e------
---------------------------------------------------------------------------------------------------------------------------------------------------------------------------------------------------------------------
--------------------c------------------------------c-------------------------------c------------c----------------------------------------c------------------c-----c----------c----c--------c----c----c---------------
--------------------#------------------------------#-------------------------------#------------#----------------------------------------#------------------#-----#----------#----#--------#----#----#---------------
--------------------#------------------------------#-------------------------------#------------#----------------------------------------#------------------#-----#----------#----#--------#----#----#---------------
=====================================================================================================================================================================================================================
