---------------------------------------------------------------------------------------------------------------------------------------------------------------------------------------------------------------------
---------------------------------------------------------------------------------------------------------------------------------------------------------------------------------------------------------------------
---------------------------------------------------------------------------------------------------------------------------------------------------------------------------------------------------------------------
---------------------------------------------------------------------------------------------------------------------------------------------------------------------------------------------------------------------
--------------------------------------------------------------------#----#-----#-----?---------#-------------------------------------------------?-------#-------#--#------------------------------------------------
-----------------------------------------------=-----------------=--------------------------------------------------------------------------------------------------------------------=------------------------------
-----------------------------------------------=-----------------=--------------------------------------------------------------------------------------------------------------------=------------------------------
----------e------------------------------------=------c---c------=------------------------------------------------------c---------------------------------------e---------------------=------------------------------
-----p-#-=-------?--------------------------=--=------#---#------=-------------------?--------------------=-------------#------=-----------------#-----------------p--------------#---==------?-#----------##--------
-----p---=-----------------=----------------=--=------c-=-c------=------------------------------------c--c=---------c---c------=-----------------------------------p------------------==-----------------------------
-----p---=-----------------=----------------=--=------#-=-#------=------------------------------------#--#=-----p---#---#p-----=-=--------------=------------------p------------------==---------------------------=-
-----p---=-----------------=----------------==-=------#-=-#------=---------------=--------------------#--#=-----p---#---#p-----=-=----=---------=------------=-----p------------------==-----------------=---------=-
==-=-======-=============-================--====-===-=========-===-===============-===-=======-==-===========-==============================--==========-=====================--=========-===========================
