---------------------------------------------------------------------------------------------------------------------------------------------------------------------------------------------------------------------
---------------------------------------------------------------------------------------------------------------------------------------------------------------------------------------------------------------------
---------------------------------------------------------------------------------------------------------------------------------------------------------------------------------------------------------------------
---------------------------------------------------------------------------------------------------------------------------------------------------------------------------------------------------------------------
#------#-#------#---###?--#--#---####-##-------##---#-?####--##-#----#----?#---#---#-?---##-#---#-----?#---#----#---#-#-----#-#-----------#------------#----##-#-----#----#-?---##-----?---##------------#--?#--#-?--
--------------------------------------------------------------------=----------------------------------------------=-------------------------------------------------------------------------------------------------
--------------------------------------------------------------------=----------------------------------------------=-----------------f-------------------------------------------------------------------------------
--------------------------------------------------------------------=----------------------------------------c-----=-----------------c------------------------------e--------------------c---------=-----------------
--#--#--#--?-=---------?------------------?------=----#-----#-------=-----?--#-------#------------#?--#---#--#-?---=-------?-----#---#=-?=--=p---#---#----------p----------p#-=-----e--#-#-----#---=--------#-----#--
-------------=-----------------------------------=------------------=----=-----------------------------------c-----=-----------------c=--=--=p--=---=-----------p----------p--=-------=--c---------=----------c------
-------------=----=------=--=--=-----------=-----=------------------=----=-----------------------------------#-----=------------------=p-=--=p--=---=-----------p----------p--=-------=--#---------=------=---#------
-------------=----=------=--=--=-----------=-----=------------------=----=-------=------------------=--------#-----=------------------=p-=-==p--=---=-----------p----------p--=-------=--#---------=------=---#------
==========-=-==-=-===========--==========-========--=-=============-==-=======-=====-=--=====-=-=====-==--====-==============-=--==-===============-======--==-=========-====-==========-=-=====-===-=-=-======-====-
