---------------------------------------------------------------------------------------------------------------------------------------------------------------------------------------------------------------------
---------------------------------------------------------------------------------------------------------------------------------------------------------------------------------------------------------------------
---------------------------------------------------------------------------------------------------------------------------------------------------------------------------------------------------------------------
---------------------------------------------------------------------------------------------------------------------------------------------------------------------------------------------------------------------
------#-------?----??-#--#--?-------?---????---?--------?--##---#-----?--------------------------------------------------?------?-------------------#---#-----------------------?------------------------------------
-------------------------------------------------------------------------------=----------=---------------------------=----------------------------------------------------------------------------------------------
-------------------------------------------------------------------------------=----------=---------------------------=----------------------------------------------------------------------------------------------
-------------------------------------------------------------------------------=--------e-=---------------------------=---------------------------------------e--c---e-----------------------------------------------
----------??????-????-------##--p---?????????e-?----#---#-------------#--------=--=---=--==------#-----------#-------==-p#-----##-?--------?---------p-----------#-=--------=--###----?---------------------p------#-
--------------------------------p---------------------c-----------c------c----c=--=---=--==-------------------------===-p----------------------------p-----------c-==-------=-------------------------------p--------
---------------------------=----p---------------------#-----------#=-----#----#=--=p--=--==-------------------------===-p----------------------------p-----------#-==-------=----------------------p--------p--------
----------------=----=-----=----p=------------=---=---#-----------#=-----#----#=--=p--=--==-------------------------===-p--------=-------------------p-----------#-==-------=----------------------p--------p--------
========-=================-========================-=====-===--=========-===========-======-==-==================-=-===-==-==--=======-=========--=-=====-==-=====-================-=-==---====-=====-========-==-===
