---------------------------------------------------------------------------------------------------------------------------------------------------------------------------------------------------------------------
---------------------------------------------------------------------------------------------------------------------------------------------------------------------------------------------------------------------
---------------------------------------------------------------------------------------------------------------------------------------------------------------------------------------------------------------------
---------------------------------------------------------------------------------------------------------------------------------------------------------------------------------------------------------------------
------=?-------------------------------#---------------?-----?-------------------#---?-?--#-#--------------------#-------------------------?------------?-----#--?---------------------------------------------------
----=-=----=--------------------------------------------------------------------------------------------------=-------------------=--------------------------=-------------------------------------------------------
----=-=----=--------------------------------------------------------------------------------------------------=-------------------=--------------------------=-------------------------------------------------------
----=-=----=----------------------------c---------------------------------------------------------------------=-------------------=--------------c-----------=-------------------------------------------------------
?--?=?=#???=-??-----?-=????-?--?-?-p???-#???------?----?-?---#-??--#??p?-?-#-??----?-#p#-?-=-?p?-?-e--?-?-?-?-=??--????-??-----p-?=-=----?-#=?#??#---?#?#?---=-????---p?--=??-?--?-??-----?---??---?=----???#???-#???
----=-=----=----------=------------p----c-------------------c---------p---------------p----=--p---------------=----------------p--=-=-------=----c-----------=-------cp---=----=c-----------------c-=c---------------
----=-=----=----------=------------p----#------------p------#---------p---------------p----=--p-=-------------=----------------p--=-=-------=----#-----------=------=#p---=----=#-----------------#-=#--=-------=----
----=-=----=----=-----=------------p----#------------p------#----=----p---------=-----p----=--p-=-------------=----------------p--=-=-------=----#-----------=------=#p---=----=#-----------------#-=#--=-------=----
============-=====-==========-===================-==-=============-==========================================-============--=-==-=====--==================-========-=================================================
