---------------------------------------------------------------------------------------------------------------------------------------------------------------------------------------------------------------------
---------------------------------------------------------------------------------------------------------------------------------------------------------------------------------------------------------------------
---------------------------------------------------------------------------------------------------------------------------------------------------------------------------------------------------------------------
---------------------------------------------------------------------------------------------------------------------------------------------------------------------------------------------------------------------
----##--#-#-------?------------#---#---------#-#------#--##-#--------#----#?#------------#---#-----#------##----#-##--?---#-#--------------------#?-------#------##-#-----#----------------?---##--#--##?--#---#--#--
--------------------------=--------------------------------=------------------------------------------------------------------=------------------------------------------=-------------------------------------------
--------------------------=--------------------------------=------------------------------------------------------------------=------------------------------------------=-------------------------------------------
----------------c----c----=---------c--------------e-------=------------------------------------------------------------------=------------------------------------------=-c------------------------c---------------c
-----------=----#-?-p#----=---------#-------=-#------------=----#----------#-#p--#----p-----#---------------#-------#-?-=-----=-----------?-e=--p-?----------#--?--------=-#---------------?--------#---#-----------c
-----------=----c---pc----=---------c-------=--------------=------------------p-------p--------------------------=------=-----=--------c-----=--p-----------------------==-c------------------------c---------------c
-----------=----#---p#---==---------#p--p---=--------------=------------------p-------p--------------------------=------=-----=-=------#-----=--p-------------=---------==-#------------------------#---------------#
-------=---=----#---p#---==---------#p--p---=--------------=--=---------------p-------p--------------------------=------=-----=-==-----#=----=--p-------------=---------==-#--------------=-------=-#---------------#
============-==-========-==-====-=====-====-=========-=-=======-==-=-=-=======================-===-====-=====-=-=====-=====-======-============-=======-===--========--=======--==-====--===--===-==============--===
