---------------------------------------------------------------------------------------------------------------------------------------------------------------------------------------------------------------------
---------------------------------------------------------------------------------------------------------------------------------------------------------------------------------------------------------------------
---------------------------------------------------------------------------------------------------------------------------------------------------------------------------------------------------------------------
---------------------------------------------------------------------------------------------------------------------------------------------------------------------------------------------------------------------
-----------------------------------------------------------------------------------#--------------------?----------------------#-------------------------------#-----------?-----------------------------------------
-----------------------------------------------------------------------=---------------------------------------------------------------------------------------------------------------------------------------------
-----------------------------------------------------------------------=---------------------------------------------------------------------------------------------------------------------------------------------
-----------------------------------------------------------------------=-------------------------------------------------------------------------------------------------------------e---------e-----------------c---
-------------------?-------p-#-----------------------------?-----------=-----?---------=----------------#-------------?-----p-----------------------------------#----------?#----?----------p--------------------#---
---------------------------p--------------------------------c----------=----c----------=--------------------------c---------p---------------------------------------------------------------p--------------------c---
-------p-------------------p----------------=---------------#------p---=----#--p-------=--------------------------#---------p---------------------------------------------------------------p---------------=----#---
-------p-------------------p----------------=---------------#------p---=----#--p-------=-------------=------------#---------p--------------------------------=------------------------------p---------------=----#---
====================================--===========-=======================-===================-=======================================-==================================================-============================
