---------------------------------------------------------------------------------------------------------------------------------------------------------------------------------------------------------------------
---------------------------------------------------------------------------------------------------------------------------------------------------------------------------------------------------------------------
---------------------------------------------------------------------------------------------------------------------------------------------------------------------------------------------------------------------
---------------------------------------------------------------------------------------------------------------------------------------------------------------------------------------------------------------------
----#---------------------------------------#------?-------?--?-?----------------------?#---=----?-----------#----------------?---#------------------------?----------?-----------------------------------?-#------#-
-----=-------------------=--------------=-----------=---------------------------------------=-----=---------------------==-----=--------------------------------------------------------------=------=---------------
-----=-------------------=--------------=-----------=---------------------------------------=-----=---------------------==-----=--------------------------------------------------------------=------=---------------
-----=--------------c----=c-------------=------c----=--------c------------------------------=-----=-----c--------------c==-----=---c--------------------------------------e------c------------=------=---------------
-----=--p----#------#----=#----p--------=-#----#--p#=p-----#-#?-#----p-------------=--??----=----#=-----#----------?-#-#==----?=#--#-----p--------?--------?------?---#---------p#---?---=----=------=---##----#-----
-----=--p-----------c----=c----p--=-----=------c--p-=p-------c-------p-------------=--------=-----=-----c--------------c==p----=---c-----p----------=---------------------------pc-------=----=------=--------c------
-----=--p-----------#----=#----p--=-----=------#--p-=p-------#-------p-------------=--------=-----=-----#--p-----------#==p----=---#=----p---------p=---------------------------p#-------=----=------=--------#------
-=---=--p-----------#----=#----p--=-----=------#--p-=p-------#-------p---------=---=--------=-----=-----#--p-----------#==p----=---#=----p---------p=---------------------------p#-------=----=-----==--------#------
======================-============-==-=======-==-=====---=====-=========-========-======-======-===-==========-===========-============================================================-============================
