---------------------------------------------------------------------------------------------------------------------------------------------------------------------------------------------------------------------
---------------------------------------------------------------------------------------------------------------------------------------------------------------------------------------------------------------------
---------------------------------------------------------------------------------------------------------------------------------------------------------------------------------------------------------------------
---------------------------------------------------------------------------------------------------------------------------------------------------------------------------------------------------------------------
-----------------?-------?--#-----#-------#------------------?--------------------?--?---------------?------------------------#--#--------?#-#---?------------------------------------------#---------#----#=-----?-#
-=---------------------------------------------------------------------------------------------------------------------=--------=-----------------------------------------------------------------=---------=--------
-=---------------------------------------------------------------------------------------------------------------------=--------=-----------------------------------------------------------------=---------=--------
-=-------------------------------------------------e----------------------------------------------------------------c--=--------=-----------------------------------------------------------------=---------=--------
-=p--------------#-p---p-#-----p---------------=-------------?-------#-?-------#--?--?--------#------#------------?-#?-=--------=-#----#--#------#p-----------p-----p---------------#--?--p-------=----#--#-=-----#--
-=p------------=---p---p-------p---------------=----------------------------------------------------c---------------c--=--------=--c--------------p-----------p-----p---------------------p------c=c--------=--------
-=p------------=---p-=-p=-=----p---------------==----------=-----------------=------------------=---#---------------#--=--------=--#--------------p-----------p-----p---------------------p=----=#=#--------=--------
-=p-----=------=---p-=-p=-=----p---------------==--------=-=-----------------=-------------=----=--=#---------------#--=--------=--#--------------p-----------p-----p---------------------p=----=#=#--------=--------
====================-========================================================================================--===========-=============================================-========-===-========-==================-===
