---------------------------------------------------------------------------------------------------------------------------------------------------------------------------------------------------------------------
---------------------------------------------------------------------------------------------------------------------------------------------------------------------------------------------------------------------
---------------------------------------------------------------------------------------------------------------------------------------------------------------------------------------------------------------------
---------------------------------------------------------------------------------------------------------------------------------------------------------------------------------------------------------------------
------------------------------?-#--------###-----------------------?-?---------------#-------------#---------#-------------------?-------?---#-----------------------------------------------------------------?-----
----------------------------------------=----------------------------------------------------------------------------------------------------------------------------------------------------------------------------
-------=--------------------------------=----------------------------------------------------------------------------------------------------------------------------------------------------------------------------
---c---=--------------------------------=-------e---------e-c----e----------------------e--------------e----------------------------------------e------------------------------------c-------------------------------
---#---=------------#---------?-----p---=-----p-------p-----#-?#---?-#---------------------------#-------?-------#------------#--?----#--#-------------?-p#---#----=?-p--------------#-------------------------?#----
---c---=--------=-------------------p---=-----p-------p-----c-----------------------------c--------------------------------------------------------------p---------=--p----c------=--c-------------------------------
---#---=--------=------=------------p---=-----p-------p--p--#-----------------------------#---------=-----------p----------------------------------------p---------=--p----#------=--#-----------------------=-------
---#---=--------=------=------------p---=-----p-------p--p--#-----------------------------#---------=-----------p----------------------------------------p---------=--p----#------=--#-----=-----------------=-------
==============-====================-===============-=========-=========-=======================--=======-=================================-=-==-=-==-=-=-==-==================================--=====================
