---------------------------------------------------------------------------------------------------------------------------------------------------------------------------------------------------------------------
---------------------------------------------------------------------------------------------------------------------------------------------------------------------------------------------------------------------
---------------------------------------------------------------------------------------------------------------------------------------------------------------------------------------------------------------------
---------------------------------------------------------------------------------------------------------------------------------------------------------------------------------------------------------------------
-------?------?#-##-#-------------##----#-----##----#-------#---#----------------#--?-------#------#--###-#---------#--#---#---?---#--##-?-??-?-?----#--#-------#---------#-----?-#-#------#--------------------#----
-----------------------------------------------------------------------------------=---------------------------------------------------------------=---=------------------------------=------=-----------------------
-----------------------------------------------------------------------------------=---------------------------------------------------------------=---=------------------------------=------=-----------------------
-------------------------------------------------------------e-------e-------------=-------------------------------e-------------------------------=---=------------------------------=------=-----------e-----------
-----#-#------?------------#-------------------------------------------------------=#-?----------------------------------------#---------?-??=#-?--=---=--------------------p---#p----=------==#--------p--?-?-------
-----------------------------------------------------------------------------------=-=-------------------------------c---------------=----c--=-----=---=--------------------p----p----=------==---------p------------
--=--------=---------------------------------=-------------------------------------=-=-------==----------=-----------#---------------=----#--=-----=---=--------------------p----p----=--=---==--=------p---------=--
--=--------=---------------------------------=-------------------------------------=-=-------==----------=-----------#---------------=----#--=-----=---=-=------------------p----p-=--=--=--===--=------p---------=--
======-==============-====-===============================-===-==========-================-==========-====================-======--=-=============================-==================================================
