---------------------------------------------------------------------------------------------------------------------------------------------------------------------------------------------------------------------
---------------------------------------------------------------------------------------------------------------------------------------------------------------------------------------------------------------------
---------------------------------------------------------------------------------------------------------------------------------------------------------------------------------------------------------------------
---------------------------------------------------------------------------------------------------------------------------------------------------------------------------------------------------------------------
---------?---------------------------------------------------------------------------------------------?----------------------------------?---------------------?--------------#----------------------??-------------
---=-------------------------------=---------------------------------------------------------------------------=----=---------------=--=------------------=----------------------------------------------------------
---=-------------------------------=---------------------------------------------------------------------------=----=---------------=--=------------------=----------------------------------------------------------
---=-------------------------------=------------------------------------------------c--------------------------=----=e--------------=--=------------------=----------------------------------------------------------
---=-----#-p-----p------------pp#--=-p#-----------#---#---p------p-p-------p---p----#p--#p----p----p--p#----#--=p---=-p-#p--------=-=--=--#----p---p-=--p==-----#---------p---p----p-#----------------###-p----------
--c=-------p-----p------------pp---=-p----=---------------p------p-p-------p---p----cp---p----p----p--p--c-----=p-=-=-p--p--------===--=-------p---p-=--p==---------------p=--p----p--------=-------------p----------
p-#=-------p-----p------------pp---=-p----=---------------p------p-p-------p---p----#p---p----p----p--p--#-----=p-=-=-p--p--------===--=-------p---p-=--p==---------------p=--p----p--------=------p------p---=------
p-#=--=----p-----p------------pp---=-p----=---------------p-=----p-p------=p---p----#p---p----p----p--p--#-----=p-=-=-p--p--------===--=-------p---p-=--p==---------------p=--p----p--------=------p------p---=------
==============================================-=============================================-===-====================================-===-============================-=-============================================
