---------------------------------------------------------------------------------------------------------------------------------------------------------------------------------------------------------------------
---------------------------------------------------------------------------------------------------------------------------------------------------------------------------------------------------------------------
---------------------------------------------------------------------------------------------------------------------------------------------------------------------------------------------------------------------
---------------------------------------------------------------------------------------------------------------------------------------------------------------------------------------------------------------------
----??----??--------?-------?---?--???--?--??-------------?--------?-?---------?--?---???-?-?-?----------?----?------??-??----?--------??----?--?--????---??-----?-----?----??--?---?--?----?----?-??--?--?-----?----
---------------------------------------------------------------------------------------------------------------------------------------------------------------------------------------------------------------------
-------------------------------------------------------------------------------------------------------------------------------------------------------------------------------------------f-------------------------
-------------------------------------------------------------------------------------------------------------------------------------------------------------------------------------------c-------------------------
#---???????????#---???--p---???#?????????????----?-##----???????????????---p#-?????--????????????????-#--???????--?????????????????-??????????e????????????????????????????????????????????#?????????????????????????
---=--------------------p-------------------------=------------------------p---------------------------------------------------------------------------------------------------------------c-------------------------
---=--------------------p-------------------------=------------------------p-----------------------------------------------------------------------------------------------------------------------------------------
---=--------------------p-------------------------=------------------------p-=-------------------------=-------------------------------------------------------------------------------------------------------------
=====================================================================================================================================================================================================================
