---------------------------------------------------------------------------------------------------------------------------------------------------------------------------------------------------------------------
---------------------------------------------------------------------------------------------------------------------------------------------------------------------------------------------------------------------
---------------------------------------------------------------------------------------------------------------------------------------------------------------------------------------------------------------------
---------------------------------------------------------------------------------------------------------------------------------------------------------------------------------------------------------------------
-#---?--------------------------------------#?----#-----#------------------#----#---------------------#-----?---------------?----------------#?------------------#---#-------------------#---#--#----------------?---
---------------------------------------------------------------------------------------------------------------------------------------------------------------------------------------------------------------------
---------------------------------------------------------------------------------------------------------------------------------------------------------------------------------------------------------------------
------------------------------------------------c---------------------------------------------------------------------------------------------------------------e-------------c-------------------------c----e--c----
-----#--#------?------?---------#------------?--#----------------------?-----p--------------?----#----------#------#------?-?------------p----?------------?-?-----------?----#---------------------?---#-?-----#?--#
-----------------------------------c------------c----------------------------p-----------------------------------------------------------p---------------=--------------------c-------p------------c----c-------c----
--p--------------------------------#------------#----------------------------p------------------------------------p----------------------p---------------=-----=--------------#-------p------------#----#-------#----
--p--------------------------------#----=-------#----------------------------p------------------------------------p----------------------p---------------=-----=--=-----------#-------p------------#----#-------#----
===-==-=======================================================================================-=========-==-============-======-================-==============================-=====================================
