---------------------------------------------------------------------------------------------------------------------------------------------------------------------------------------------------------------------
---------------------------------------------------------------------------------------------------------------------------------------------------------------------------------------------------------------------
---------------------------------------------------------------------------------------------------------------------------------------------------------------------------------------------------------------------
---------------------------------------------------------------------------------------------------------------------------------------------------------------------------------------------------------------------
-#------------?-----#####-#---##----#-?-##---#------##-#-------#--#-#-----#--#--#-?--#--?#-#--#--#?-------#--###-#----?#-?---###---##---------------------#-----#---#---#-#----##--#---#-##-##--#-#-##?---??---------
-----------=---------------------------=----=----=----------------------==-------------------------=-------------------------------------===-=-=----=----------------------------------------------------------------
-----------=---------------------------=----=----=-------------------ff-==-------------------------=-------------------------------------===-=-=----=----------------------------------------------------------------
----c------=---------------------------=----=-e--=-------------------cc-==----c----c---------------=-------------------------------------===-=-=----=--------------------=-----------------------------e-------------
--=-#--p-#==--#=------------p----#----#=----=----=#--------#----?----##-==--=-#---##----#---------#=----------------?-#--#-#------=------===-=-=--#-=----------p---------=----------------------------?-?-##???p-?=-?
--==c--p--==---=------------p----------=----=----=-------------------ccc==--=-c----c---------------=------------------------------=------===-=-=----=----------p---------=-------------------------------------p=-=--
--==#--p--==---=---=--------p----------=----=----=------------=--------#==--=-#----#---p-----------=------------------------------=------===-===----=----------p---------=--------------p----------------------p=-=--
--==#--p--==---=---=--------p----------=----=--=-=------------=--------#==--=-#----#---p--=--------=---------------=------------=-=------===-===----=----------p---------=--------------p----------------------p=-=--
-====-======--==---========-==============--=============-============================-=====-============-======-==========================================-=======-==-====----==--=-=-=======-==-=-=====-===========
