---------------------------------------------------------------------------------------------------------------------------------------------------------------------------------------------------------------------
---------------------------------------------------------------------------------------------------------------------------------------------------------------------------------------------------------------------
---------------------------------------------------------------------------------------------------------------------------------------------------------------------------------------------------------------------
---------------------------------------------------------------------------------------------------------------------------------------------------------------------------------------------------------------------
--------------#-----?--?--------#---------#---------#----#--------#--#---------#-?--#----#----------#----#----#-------------------------?------------#---------------------#--------------##-#-----------#-----?-----
--=--------------------------------=--------------------=------------------=--=-----------------=-----=---==----=--------------------------------------=------------------------=--=-------------------------------=-
--=--------------------------------=--------------------=------------------=--=-----------------=-----=---==----=--------------------------------------=------------------------=--=-------------------------------=-
--=---------------------c----------=--------------------=------------------=--=-------------c---=-----=---==----=--------------------------------------=----------c---------c---=--=-------------------------------=-
--=----------------?????#---?=-----=-#------------------=-------------#-=--=--=--?----p-p---#---=-----=-#-==----=---------------------=-#---=--#----?--=--=-------#-------#-###-=#-=-------------#-----------#-#-#-=?
--=---------------------c-=--=-----=--------------------=---------------=c-=--=-------p-p---c---==-=--=---==---c=----------------=----=-----=----------=--=-------c---c-----c---=--=--==---------------------------=-
--=------=p-----p-------#-=--=-----=--------------------=--------p------=#-=p-=-------p-p---#---==-=--=---==---#=----------------=----=-----=-=--------=--==----=-#---#-----#---=--=--==----=-----------------p----=-
=-=------=p-----p-------#==--=-----=--------------------=---=----p--=---=#-=p-=-------p-p---#---==-=--=---==---#=---------------==----=-----=-=--------=--==----=-#-=-#-----#---=--=--==----=----------=------p----=-
====---=-===--===-===============--====---==-===-=-====-===-==--===-======-==================-=-==-==============-==-====---===-==================-=====--==-====-=======-==============-======-==-=---=====-=====-==
