---------------------------------------------------------------------------------------------------------------------------------------------------------------------------------------------------------------------
---------------------------------------------------------------------------------------------------------------------------------------------------------------------------------------------------------------------
---------------------------------------------------------------------------------------------------------------------------------------------------------------------------------------------------------------------
---------------------------------------------------------------------------------------------------------------------------------------------------------------------------------------------------------------------
-?--------------------------?------------------------#--#---------------------------#--------------------------------?--#---?-?----------------------------------------------------------#--------#------------------
--------------------------------------------------=---------------------------------------------------------------------------------------------------=-------=-----------------------------==-----------------------
--------------------------------------------------=---------------------------------------------------------------------------------------------------=-------=-----------------------------==-----------------------
----------------------c---------------------------=---------------------------------------------------------------------------------------------------=-------=-----------------------------==-----------------------
-#=---=---------------#p----#----p----------------=#---=-p--#----==-=--#-#---?-----------=-p-------------=-p---------#==----#-#pp-------------------=-=-------=--p-----------------=--------==p=?--p-----------------
--=---=--------=------cp---------p----------------=----=-p-------==-=--------------------=-p--c---=-----==-p-c--------==-----=-pp------------=------=-=-------=--p-----------------=--------==p=---p-------c---------
--=---=--------=------#p---------p----------------=----=-p---=---==-=--------------------=-p=-#---=-----==-p-#--------==-----=-pp-------=----=------=-=-------=--p-----------------=-------p==p=---p-------#---------
--=---=--------=------#p---------p----------------=----=-p---=---==-=---=----------------=-p=-#=--=-----==-p-#--------==-----=-pp-------=----=------=-=-------=--p-------=---------=-------p==p=---p-------#--------=
-==-========-=====--======================-======-========-========-=============-=-======-========--=====-==========================--========-========-=============-===--=-==-===-=======================-=-====-=
