---------------------------------------------------------------------------------------------------------------------------------------------------------------------------------------------------------------------
---------------------------------------------------------------------------------------------------------------------------------------------------------------------------------------------------------------------
---------------------------------------------------------------------------------------------------------------------------------------------------------------------------------------------------------------------
---------------------------------------------------------------------------------------------------------------------------------------------------------------------------------------------------------------------
----?-------------#----------?-----------------------#------------#------#-------??-#--#---?--#----------------------------------------#-------?------?---?-----------#----------#---#--------------#----------------
---------------------------------------------------------------------------------------------------------------------=--------------------=--------=----=------------------------------------------------------------
---------------------------------------------------------------------------------------------------------------------=--------------------=--------=----=------------------------------------------------------------
---------------------------------------------------------------------------------------------------------------------=----------e---------=--------=----=--------------------------c-------------------------------c-
----#--#-----#---------p-----#?---=-p--=----------------#-p---------#--p=-----?--#??-----?-?------=----------?-------=------------------p?==---?--?=--#-=-#----?--------=-#--=-----#-----------#--=?---p-----------#-
-----------------------p----------=-p--=------------------p------------p=--------------------=----=------------------=------------------p-==-------=----=---------------=----=-----c--------------=----p-----------c-
-=------=------=-------p----------=-p--=----------=-------p------------p=----p--------p------=----=----=p-p-------=--=------p-----------p-==-------=----=-------p-=-----=--p-=-p---#---=-----p--p-=----p-p---------#-
-=------=------=-------p--------=-=-p--=----------=-------p------------p=----p--------p------=----==---=p-p------==--=------p----=------p-==-------=----=-------p-=-----=--p-=-p---#---=-----p--p-=----p-p---=-----#-
-=-===-==----=-=-==----=-=-===============-==-=-=-====--=====-=-=-===-====-=-===-=====================-==-=========-===--==-=--===----======--===-==-======--====-==============-=====-=-==--===========-=--=====--==
