---------------------------------------------------------------------------------------------------------------------------------------------------------------------------------------------------------------------
---------------------------------------------------------------------------------------------------------------------------------------------------------------------------------------------------------------------
---------------------------------------------------------------------------------------------------------------------------------------------------------------------------------------------------------------------
---------------------------------------------------------------------------------------------------------------------------------------------------------------------------------------------------------------------
#-------?#?-----?----------------------------------?----?-----------#-=-------------------------#--------?---=--?-------------------#-------------#-----------?---#--?-----#---------?--------------------------?----
-----=------------=----------------------------=----------------------=--------------------------------------=-------------------------------------------------------------------------------------------------------
-----=------------=----------------------------=----------------------=--------------------------------------=-------------------------------------------------------------------------------------------------------
--c--=------------=------------------------e=--=----------------c-----=--------------------------------------=-------------------------------------e----------------------------------------------------------c------
--#?-=-??-#?--?-#-=p------pep?---?-?-?-?----=--=---#--p-?-?-?---c?----=???-??--?-p----??----=--#----==-?-#-?-=--?------?---p----?pp?---p--?--p---?----?p-?-#p-#-----#?-#--#--=?-p?p?-?-#-??--?-?=??---?-?--?--#-#--?p
--c--=-------c----=p-c--==p-p---------------=c-=c-----p---------c-----=----------p---------==-------==-------=------------cp-----pp---=p-=---pc--------p----p---------------==--p-p-------------=--c--------c-cc----p
--#--=-------#----=p-#--==p-p---------------=#-=#-----p--------p#-----=----------p---------==-----=-==-------=------------#p-----pp---=p-=---p#--------p----p---=-----------==--p-p-------------=--#---=----#-##----p
--#--=-------#----=p-#--==p-p---------------=#-=#-----p--=-----p#-----=----------p---------==-----=-==-------=------------#p=----pp---=p-=---p#--------p----p---=-------=---==--p-p-------------=--#-=-=----#-##----p
====-============-====-=======--=================-==-==-=====--===========-=====-===============-===========-=-================-===============-==-======================================================--==========
