---------------------------------------------------------------------------------------------------------------------------------------------------------------------------------------------------------------------
---------------------------------------------------------------------------------------------------------------------------------------------------------------------------------------------------------------------
---------------------------------------------------------------------------------------------------------------------------------------------------------------------------------------------------------------------
---------------------------------------------------------------------------------------------------------------------------------------------------------------------------------------------------------------------
---#-----------=-------------?#-------#---#---#-?---#-------#---#---#-#----#--#------#-?----#------------#-#--#---#---?#---#----#------#-------?-------#----------##-------#-------------------------#-------#---#--#
--------------==----------------------------------------=-----------------=----------------------------------------------------=---------------------=----------=----------------------------------------------------
--------------==----------------------------------------=-----------------=----------------------------------------------------=---------------------=----------=----------------------------------------------------
--------------==-------------------------e-----e--------=-----------------=-----=--------------c----------------------------c--=---------c-----------=----e-----=----------------------c--------------------------e--
-----?--------==--------=----#-----p--------?---?----=--=---------?-------=-p---=------#-?#----#---#----#-------------?-----#--=--=-p----c##-#-#?----=--------#-=-----p-#-----#---?----#-----------------------------
=c------------==c-==----=----------p-----------------=--=----------------==-p---=--------------c-------c-----------c--------c--=--=-pc---c-----------=----------=-----p----------------c-----------------------------
=#------------==#-==----=----------p-----------------=--=----------------==-p---=---=---------p#------=#-----------#--------#-p=--=-p#---#--------=--=-----=----=-----p----------------#------=----------------------
=#-------=----==#-==----=----------p-----------------==-=----------------==-p---=---=---------p#------=#-----------#--------#-p=--=-p#---#--------=--=-----=----=-----p----------------#------=----------------------
======-=============--====-=========-=============--======--==-=========================-=======-=-=========--===-==-=====-=========================================-===============-========-====-=-===========-====
