---------------------------------------------------------------------------------------------------------------------------------------------------------------------------------------------------------------------
---------------------------------------------------------------------------------------------------------------------------------------------------------------------------------------------------------------------
---------------------------------------------------------------------------------------------------------------------------------------------------------------------------------------------------------------------
---------------------------------------------------------------------------------------------------------------------------------------------------------------------------------------------------------------------
##---?--#---#---------------#-------=-#--------------------------#---------#----#---#---------------##-####---------#------?-------#--#---#---------#----##--#-#--#---#-----------------------#-----##---#---------#-
------------------------------------=--------------------------------------------------=------------------------------=----------------------------------------------------=----------------=---=--------------------
------------------------------------=--------------------------------------------------=------------------------------=----------------------------------------------------=----------------=---=--------------------
----------------------e-------------=--------------------------e---c-------------------=------------------------------=------------------c---e---e-------------------------=---------c-c-e--=---=-----------e--------
----##?--------#-#-p=--?--=p-p----?-=------------#-----------------#--------#---------==---?------------------p##ep---=----#-------------#-----------=----------=----------=---?----##-#---===--=--p---p--#----------
----------------=--p=-----=p-p------=------------------------------c---------------=--==----------------------p---p---=------------------c---------c-=----------=----------=-----=---c-c---===--=--p---p-------------
----------------=--p=-----=p-p------=----------------=----------=--#---------------=--==-----------=--=-------p---p---=----------------=-#---------#-=----------=----------=-----=---#-#---===--=--p---p------------=
----------------=--p=-----=p-p------==---------------=----------=--#---------------=--==-=---------=--=-------p---p---=----------------=-#---------#-=----------=------==--=-----=---#-#---===--=--p---p----------=-=
=========--==-====-==-===-====--=======--==-=-==-=---=============-==-===-====-=============-==--=-=======================-==--=---=--========-========-===-=====-=-=-============-=====-========-==============-====
