---------------------------------------------------------------------------------------------------------------------------------------------------------------------------------------------------------------------
---------------------------------------------------------------------------------------------------------------------------------------------------------------------------------------------------------------------
---------------------------------------------------------------------------------------------------------------------------------------------------------------------------------------------------------------------
---------------------------------------------------------------------------------------------------------------------------------------------------------------------------------------------------------------------
-------#------#-#---?#?---##--------#-####---#-#---#-#--------?-------#----#--#-#-##-------##--###?-#------###-#---------#-#---#--##---#--?-?------?-?#--##------#--#-#-----#-#---------#---------?---#--##--#-?---?-
-----------------------------------------------------------------=----------------------------------------------------------=----------------------------------------------------------------------------------------
-----------------------------------------------------------------=----------------------------------------------------------=----------------------------------------------------------------------------------------
---e--e----e-e----------e---c-----e--------------------=-----e---=------e-----------------------------e--e------------------=----e----e-----------e---------e------------------e-----e------------------------------e
--------------------#-?-----#-------------------------p=---#--?--=-----#-p-------------#----------#----p--#---p---------#---=p------------#-?p-?---#-#-#---p--##p--p-------p-#------p-p-----------?------------#---#-
----------------------------c-------------------------p=---------=-------p-----------------------------p------p----=--------=p---------------p-------------p----p--p-------p--------p-p------------------------------
------------=---------------#---------------=---------p=---------=-------p--------------=--------------p------p----=--------=p---------------p-------------p----p--p-------p--------p-p-------------=----------------
-=----------=-----=---------#---------------=---------p=----=----=-------p--------------=----------=---p=-----p----=--=-----=p---------------p-------------p----p--p-------p----=---p-p-------------==---------------
====--===-===========================-===============================-==============-=-===-================================================-=====-==-===-====-===========================--======================-===
