---------------------------------------------------------------------------------------------------------------------------------------------------------------------------------------------------------------------
---------------------------------------------------------------------------------------------------------------------------------------------------------------------------------------------------------------------
---------------------------------------------------------------------------------------------------------------------------------------------------------------------------------------------------------------------
---------------------------------------------------------------------------------------------------------------------------------------------------------------------------------------------------------------------
---------------------------------------------------------------------------------------------------------------------------------------------------------------------------------------------------------------------
--------------------------------------------------------------------------------------------------------------------=-----------------------------------------------------------------------------------------=------
--------------------------------------------------------------------------------------------------------------------=-----------------------------------------------------------------------------------------=------
--------------------------------------------------------------------------------------------------------------------=-----------------------------------------------------------------------------------------=------
------------#-------------------------------------------------------------------------------------------------------=--------------------#----------------------------#---------------------------------------=------
--------------------------------------------------------------------------------------------c-----------------------=-----------------------------------------------------------------------------------------=------
--------------------------------------------------------------------------------------------#-----------------------=----------------------------------------=------------------------------------------------=------
--------------------------------------------------------------------------------------------#-----------------------=----------------------------------------=------------------------------------------------=------
=====================================================================================================================================================================================================================
