---------------------------------------------------------------------------------------------------------------------------------------------------------------------------------------------------------------------
---------------------------------------------------------------------------------------------------------------------------------------------------------------------------------------------------------------------
---------------------------------------------------------------------------------------------------------------------------------------------------------------------------------------------------------------------
---------------------------------------------------------------------------------------------------------------------------------------------------------------------------------------------------------------------
-------?--------------##---------------------?----?------------#--#-------#-------##-------#-------------------------#---#----------------#=--------------------------#-#-------#---?----------------------=-------?-
----------------------------------------=---------------=-----------------------------------------=--------------------------------=-=-----=--------=----------=------------=----------=-------=---=------==---------
----------------------------------------=---------------=-----------------------------------------=--------------------------------=-=-----=--------=----------=------------=----------=-------=---=------==---------
--------------c----------------c----e---=---------------=-----------------------------------------=--e-----------------------------=-=-----=--------=----------=----------c-=----------=-------=---=------==---------
p------#------##-----------=-#-#--------=----#----?#-p?-=-p-----------------------------------p#--=-------------------=??---?------=-=#----=--?-?-#-=----------=----------#-=-------?-?=-------=---=-p----==----p--#-
p-------------c------------=---c--------=------------p--=-p---------------------------------c-p---=------=------------=------------=-=--=--=--------=----------=--c-------c-=----------=-------=---=-p----==----p----
p-------------#------------=---#--------=------------p--=-p----------------------------=--=-#-p---=------=------------=--------p---=-=--=--=--------=----=----p=--#-------#-=----------=-------=---=-p----==----p----
p------------=#-----------==---#--------=------------p--=-p=---------------------------=--=-#-p---=------=------------=--------p---=-=--=--=--------=----=----p=--#-------#-=----------=-------=-=-=-p----==----p----
====-======-=============================-==========-===============-========-=======-====================-=---==============-==-===========-========--===-=--=====-===-=====-===========-===-=======================
