---------------------------------------------------------------------------------------------------------------------------------------------------------------------------------------------------------------------
---------------------------------------------------------------------------------------------------------------------------------------------------------------------------------------------------------------------
---------------------------------------------------------------------------------------------------------------------------------------------------------------------------------------------------------------------
---------------------------------------------------------------------------------------------------------------------------------------------------------------------------------------------------------------------
----------#--##-----------#--------------#--#--?-----##---#-------#--------#------------------##--?---##---##-------------#-----------------#-------#?----#----------##---------------#----?------#----#--------#----
------=--------------------------------------------------------------------------------------------------------------------------------------------------------------------------------------------------------------
------=--------------------------------------------------------------------------------------------------------------------------------------------------------------------------------------------------------------
------=----------c------------------e-----------c-------------------------------------------------------------------------------c-----c-----------------------------c---------------------------------c-------c------
------=----#-----#------pp-?-#--=---------=----##=-------=-----=------=---------=-----------------#-p--------#-=--------#-----?-#-=---#p--==---------#---------=----#----#--------------ppp?#=--------#-----=-#--=---
------=-=--------c------pp------=---------=-----c=-------=----c=------=-----c---=-------------------p---=------=----------------c-=--ccp--==-------------------=----c-------------------ppp--=--------c-----=-c--=---
--=---=-=--------#-==-=-pp------=---------=-----#=-------=----#=------=-----#---=---------=--------=p---=------=-p---=----------#-=--##p--==-------------------=----#-------------------ppp--=-------=#-----=-#--=---
--=---=-=--------#-==-=-pp------=---------=-----#=-------=----#=------=-----#---=--=----=-=--------=p---=------=-p---=----------#-=--##p--==---=---------------=----#-------------------ppp--=-------=#-----=-#--=---
============================-=-========-=====--=====-=======-======-======-===-=======-====-=======================-=====-=======-=======-===-====-=========--===============-==-====-==========-========-===-====-==
