---------------------------------------------------------------------------------------------------------------------------------------------------------------------------------------------------------------------
---------------------------------------------------------------------------------------------------------------------------------------------------------------------------------------------------------------------
---------------------------------------------------------------------------------------------------------------------------------------------------------------------------------------------------------------------
---------------------------------------------------------------------------------------------------------------------------------------------------------------------------------------------------------------------
?-?---------------------------------------------?---------------------------------#------------------------?------------------------#---------------------------------------------?----?-----------------------------
-----------------------------=-------------------------------------------------------------------------------------------------=-------------------------------------------------------------------------------------
-----------------------------=-------------------------------------------------------------------------------------------------=-------------------------------------------------------------------------------------
---------------e--e--e-------=---------------------------------e----------------------------------------------------e---------e=-----------------------------------------e-----------------------e-------------------
???=?==-=-----p-------#--#---=------------=-----##----#-------#--------#-#---#-#--------------#--------p#pp?-------------p---=-=-#----p-----------------------p-------------------?----#--------p----------------=-p-
---=-==-=-----p--------------=------------=---c-------------c------------------------------------------p-pp--------------p---=-=------p---------------c-------p---------------------------------p----------------=-p-
---=-==-=-----p-----p--------=------------=---#p------------#--------p---------------p-----------==----p-pp--------------p---=-=------p---------------#=------p---------------------------------p----------------=-p-
---=-==-=-----p-----p--------=------------=---#p------------#--------p---------------p-----------==----p-pp--------------p---=-=------p---------------#==-----p---------------------------------p----------------=-p-
=======-======================-=====================================-======-==============================================-=-========================================================================================
