---------------------------------------------------------------------------------------------------------------------------------------------------------------------------------------------------------------------
---------------------------------------------------------------------------------------------------------------------------------------------------------------------------------------------------------------------
---------------------------------------------------------------------------------------------------------------------------------------------------------------------------------------------------------------------
---------------------------------------------------------------------------------------------------------------------------------------------------------------------------------------------------------------------
---?---#----------?----#--#--------------------------------#---------------------------------------?------------------?---------#-----?------------------#---#-------#--#-#-----?------------#----------------?------
-------------------------------------------------------------------=----------------------------------------------------=--------------------------------------------------------------------------=-----------------
-------------------------------------------------------------------=----------------------------------------------------=--------------------------------------------------------------------------=-----------------
-------------c--------------------c------------e----------------c--=-------------------------------------------------c--=-----------------------------------------e----------e---------------------=-----------------
---#------#--#----#--?-----=------#--------#----------=---------#--=--------------#------#--?------#-----=#----------###=-------------#-------------=---------------------------#----------=-------=----?-----#------
-------------c-------------=------c-------------------=---------c--=--------------------------c----------=-----------c--=---------------------------=--------------------------------------=-------=-----------------
-------------#-----p-------=------#----p--------------=--------p#--=----p-----------------p---#--------p-=-----------#--=----------------=----------=----------------------=---------------=-------=-----------------
-------------#-----p-------=------#----p--------------=--------p#--=----p-----------------p---#---=----p-=-----------#--=----------------=----------=----------------------=---------------=-------=-----------------
--==-======-=================-==========-=========-====-=========-============-========-=========-=========-===============-=-=======-======-======-================-====-==-=-===-============-============-========
