---------------------------------------------------------------------------------------------------------------------------------------------------------------------------------------------------------------------
---------------------------------------------------------------------------------------------------------------------------------------------------------------------------------------------------------------------
---------------------------------------------------------------------------------------------------------------------------------------------------------------------------------------------------------------------
---------------------------------------------------------------------------------------------------------------------------------------------------------------------------------------------------------------------
---------##------------------#--------#------?--##-------?----------?----#---------------------------------#----------------------------------#------------------------#----?-------#-------------?----------#----#--
-----------------=----------------------=-------------=---------------------------------------------------------------------------------------------------------------------------------------------=----------------
-----------------=----------------------=-------------=---------------------------------------------------------------------------------------------------------------------------------------------=----------------
-----------------=---c------------------=-------------=---------------------c---------------------------------------------------------------c-------------------------------------------e-----------=----------------
-----------?-p--?=---#?-#-----p---------=#--#?--------=#-#----------#-------#--#-p--#------=-------#----------------------=-#----?----------#---------------------?---------#--------#------p-p#--#-=---------------#
-----=-------p---=---c--------p-----=---=-------------=---------------------c----p---------=------------------------------=--------c--------c---------------------------------c-------------p-p-----=----------------
-----=-------p---=---#--------p-----=---=-----p-------=---------------------#----p---------=-------------=----------------=--------#--------#---------------------------=-----#---=------p--p=p-----=----------------
---=-=-------p---=---#--------p-----=---=-----p-------=---------------------#----p------=--=-------------=----------------=--------#--------#-------------=-------------=-----#---=------p--p=p-----=----------------
---=-=---==========-===-=-=-======-====-==--===-==--======----=====-=-=-==--==-=-=-====-=======-==-==----=-=----------=---=-=--===-=--=-==--=-=-=-=======-==-=----=-=====---====-==-===-==--====-=====-==----=-====-=
