---------------------------------------------------------------------------------------------------------------------------------------------------------------------------------------------------------------------
---------------------------------------------------------------------------------------------------------------------------------------------------------------------------------------------------------------------
---------------------------------------------------------------------------------------------------------------------------------------------------------------------------------------------------------------------
---------------------------------------------------------------------------------------------------------------------------------------------------------------------------------------------------------------------
-------------------------------#----------#--#----------------------------------------#----------#--#---------------------------#-------------------------------?----------#----?--------------------#--#--#--=------
---------=------=-----=--=-=-----=-------------------------------------------------------------------------------------------------------------------------=--=---------------------------=------------=------=-=-=--
---------=------=-----=--=-=-----=-------------------------------------------------------------------------------------------------------------------------=--=---------------------------=------------=------=-=-=--
---------=------=-----=--=-=-----=e------------------------------c-e--------------------------------------------c----------------------------------c-------=--=---------------------------=------------=-c--c-=-=-=--
-------#-=------=-----=##=-=-----=---=--=---=--------------------#-------------=#-----------------------------p=c=-----=p-#----------?-=#----------#-p-----=--=-#-----#---------#---#---#-=--p-?=------=-#--#==-=-=--
---------=--=-=-=-----=--=c=c----=---=--=---=----------=---------c------c------=-c==-=------------=-----------p=c=-----=p--------------=---=-------c-p-----=-==----------=----------------=--p--=------=-c--c==-=-=--
---------=--=-=-=-----=--=#=#----=--==--=---=----------=---------#------#------=-#==-=------------=-----------p=#=-----=p----=---------=---=---=---#-p-p---=-==----------=----------------=--p--=---=--=-#--#==-=-=--
---------=--=-=-=-----=--=#=#----=--==--=---=----=-----=---------#------#------=-#==-=---=--------=-----------p=#=-=---=p----=---------=--==---=---#-p-p---=-==----------=----------------=--p--=---=--=-#--#==-=-=--
==-==============-=========================-====-=====-====---=-=====--===-=================-========-===================================-==-===========-============-========================-================-=====
