---------------------------------------------------------------------------------------------------------------------------------------------------------------------------------------------------------------------
---------------------------------------------------------------------------------------------------------------------------------------------------------------------------------------------------------------------
---------------------------------------------------------------------------------------------------------------------------------------------------------------------------------------------------------------------
---------------------------------------------------------------------------------------------------------------------------------------------------------------------------------------------------------------------
---------------------#--#-#----------------------------#------#-------------#----#---------------#-##---------?----#--?-#--#?##----#--#-??-#------#######---#??--##--------??-?---?-??--?--#?#--------?----???-?----?
-----------------------------------------------------------------------------------------------------------------------------------------------------------------------=-----------------=---------------------------
--------------------------------------------------------------------------------------------------------------------------------------------------------------------f--=-=---------------=---------------------------
---------------e---------------------------------------------------------------------------------------c-------------------------------------------------=----------c--===---------------=----------------------=----
--p-----p--p-------------------------------------------------------------------------------------------#------#-------?-----#-----------##---#-----------=#--##p----#-====-?#-???????????=--#--?----????-?e?????=????
--p-----p--p-------------------------------------------------------------------------------------------c-------------------------------------------------=-----p----c-====c--------------=----------------------=----
--p-----p--p-------------------------------------------------------------------------------------------#-------------------------------------------------=-----p------====#--------------=----------------------=----
--p-----p--p-------------------------------------------------------------------------------------------#-------------------------------------------------=-----p------====#--=-----------=----------------------=----
====--====-==--=-----=--=-=----------------------------=------=----------=--=----=--=------------=-==--=-=----=--=-==-=-=--====----=--=-==-=-==-=-=========-====-==-=================================================
