---------------------------------------------------------------------------------------------------------------------------------------------------------------------------------------------------------------------
---------------------------------------------------------------------------------------------------------------------------------------------------------------------------------------------------------------------
---------------------------------------------------------------------------------------------------------------------------------------------------------------------------------------------------------------------
---------------------------------------------------------------------------------------------------------------------------------------------------------------------------------------------------------------------
--#---------?-----#?-----------------------#----#--------------------------#-?------------------------?#------------------------------------?-?-------------------------#----------------------#------------------#--
-=-------------------------------------------------------------------------------------------------------------------------------------------------------------------------------------------------------------------
-=-------------------------------------------------------------------------------------------------------------------------------------------------------------------------------------------------------------------
-=---------------------------------------------------e-e-------------------------------------------------------------------------------------------------------------------------------------------------------------
-=----------#------#--p-#-----p-----------------------------------------?----?------?-----------------?----------------=--------------------?p#---=-----------=------------------=-#---------------------p#?---------
-=---------------=----pc------p-----------------------------------=-c--------------------------------------------------=---------------------p----=-----------=------------------=-----------------------p---=-------
-=------p-------p=----p#------p-=---------------------------------=-#-----------------------=--------------------------=---p-----------------p----=-----------=------------------=------------------=----p---=-------
-=------p-------p=----p#------p-=---------------------------------=-#-----------------------=--------------------------=---p-----------------p----=-----------=---=--------------=------------------=----p---=-------
==========-===-==========-===-==========-========-============-====-==========-===-=====-====================-======-===========-=====--==============-=====-==============================-==-==-===============-===
